00000000000000000000000000000000000000
00001110000000000000000000000000000000
00000000000011110000000000000000000000
00000000000000000000000001111110000000
00000000001111100000000000000000000000
00000000000000000111000000000000000000
00000000000000000000000000000000000000
00000000111111100000011000001110000000
00000000000000000000000000000000000000
00000000111000000000000000000000000000
00000000000000111100000000000000000000
00000000000000000000000011111110000000
00000000000000111100000000000000000000
00000000000000011111100000000000000000
00000110000000000011111000000000000000
00000000000000000000011111000000000000
00000000111000000000000011110000000000
00000000110000000000000000000000000000
00000000000000000111000000000000000000
00000000000000000000000000000000000000