00000000000000000000000000000000000000
01111000000000000000000111110000000000
00001111111110000111011110000000000000
00000000000000000000000000000000000000
00000000000000000000000000000000000000
00000000000000111000000000000000000000
00000000000000000000000000000000000000
00000000000000000000000000000000000000
00000000000000000000000000000000000000
00000000000000000111111111000000000000
00000001111000000000000000000000000000
00000000000000000000000000000000000000
00000000000000000000001111110000000000
00000000000000000000000000000000000000
00000000000000000000000000000000000000
00011111000000000111100000000000000000
00000001000000000000000000000000000000
00000001000000000000000000000000000000
00000000000000000000000000000011100000
00000000000000000000000000000000000000